abolition	废除
abundance	丰富
accord	一致
according	根据（后跟to）
accountable	应负责的
ace	（扑克牌里的）A；佼佼者
adjective	形容词
adverb	副词
advocacy	提倡
aerial	空中的
aeroplane	飞机
affluence	富裕
affluent	富裕的
aggression	侵略
air-conditioner	空调
air-conditioning	空调
aisle	过道
alert	警惕的；警报
allege	声称
alliance	联盟
ally	盟友
ambitious	有雄心的
amid	在…当中
amidst	在…当中
ancestry	祖先
anew	重新
angel	天使
apparatus	仪器
applause	掌声
appliance	器具
aptitude	天赋；能力
argumentative	论证的
armament	〈总称〉武器
arouse	激发
ashore	在岸上
ass	驴；傻瓜
asset	资产；优势
astronomical	天文的
atop	在…顶上
attentive	专心的
attic	阁楼
attorney	律师
audio	音频
auditorium	礼堂
authorise	授权
automobile	汽车
aviation	航空
await	等候
awe	敬畏
axe	斧头
axis	轴
backup	备份
backyard	后院
badge	徽章
bail	保释
bait	诱饵
ballot	投票
bang	猛击
banknote	钞票
bankrupt	破产
bankruptcy	破产
banner	旗帜
banquet	宴会
barrel	桶
batch	一批
battalion	营
beam	梁
beforehand	事先
beloved	心爱的
berry	浆果
best-seller	畅销书
best-selling	畅销的
bet	打赌
beverage	饮料
Bible	圣经
billionaire	亿万富翁
bin	箱
biochemical	生化的
biochemist	生物化学家
biographer	传记作家
biotechnology	生物技术
bitch	母狗；〈禁忌〉泼妇
blade	刀片
blast	爆炸
blend	混合
blonde	金发女郎
bloom	花；开花
blossom	花；开花
blueprint	蓝图
blur	模糊
boast	自夸；拥有
bold	大胆的
bolt	闩；螺栓
bondage	束缚
boomer	生育高峰出生的人
boost	提升
bowel	肠
bracket	支架
brag	自吹
brandy	白兰地酒
brass	黄铜
breadth	宽度
breakdown	故障
breed	饲养；品种
breeze	微风
bribe	贿赂
briefcase	公文包
brilliance	杰出
broker	经纪人
brow	眉毛
browse	浏览
brute	野兽；冷酷无情的人
bubble	泡沫
buck	〈口语〉美元
bucket	提桶
buckle	扣环
bud	花蕾
buddy	好友
bug	昆虫；【计算机】出错
bulb	灯泡
bull	公牛
bullet	子弹；项目符号
bulletin	布告
bully	欺负别人的人
bump	碰撞；减速路脊
bundle	一捆
bureau	局
bypass	旁道
bystander	旁观者
cabin	舱；小木屋
cabinet	内阁
cable	电缆
calendar	日历
calf	小牛，牛犊
calorie	卡路里
campus	校园
cane	竹杖；甘蔗
capita	人均（前跟per）
capitalism	资本主义
capitalist	资本主义的
capture	捕获
cardboard	纸板
career	职业生涯，事业
cargo	货物
cart	大车
cashier	收银员
cellar	地窖
cell-phone	〈口语〉手机
Celsius	摄氏度
cement	水泥
cereal	谷类
chairperson	主席
champagne	香槟酒
chaotic	混乱的
charitable	慈善的
charity	慈善；慈善机构
charm	魅力
charter	宪章
chase	追，追逐
cherish	珍惜
chill	寒冷
chimney	烟囱
chin	下巴
chip	芯片
cholesterol	胆固醇
chop	劈；大块
chore	苦差事
claim	宣称；索赔
clash	冲突
clerical	文书的
client	客户
cliff	悬崖
climax	高潮
cling	紧紧抓住
clip	剪短；片段
clockwise	顺时针地
clown	小丑
clue	线索
coarse	粗的；粗糙的
cock	公鸡；〈禁忌〉男性生殖器
cohesion	凝聚力；衔接
coil	线圈
collaborate	合作
colon	冒号；结肠
colony	殖民地
column	列
columnist	专栏作家
combat	战斗
comma	逗号
commonplace	司空见惯的
commune	公社
commute	通勤
compel	迫使
competent	能干的
complain	抱怨
complaint	投诉
compliance	遵守
complicate	使复杂
comply	遵守
comrade	同志；战友
conceal	藏
concerted	协调一致的
condense	压缩
confess	承认
confront	面对
Confucian	孔子的，儒家的
congress	国会
conjunction	连词
conquer	征服
conquest	征服
conscientious	认真的
consolidate	巩固
contaminate	使不干净，污染
contempt	蔑视
contend	争夺
contentious	争夺的
contest	比赛
contraction	收缩
cop	〈口语〉警察
cope	应对（后跟with）
copper	铜
copyright	版权
cord	绳
cornerstone	基石
corps	兵团
correspondent	记者
corridor	走廊
cosmic	宇宙的
cosmos	宇宙
costume	服装
couch	长沙发
council	委员会
counsel	谘询；律师
countdown	倒计时
counterpart	对应
county	县
coupon	优惠券
coward	懦夫
cowboy	牛仔
crab	螃蟹
crack	裂纹
cracker	饼干
craft	工艺
crane	鹤；起重机
crawl	爬行
craze	热，狂热
creditable	值得肯定的
creep	爬行
crisis	危机
critic	评论家
criticise	批评
criticism	批评
crocodile	鳄鱼
crown	王冠；花冠
cruise	邮轮
crush	压碎
crystal	水晶
cucumber	黄瓜
cue	提示
cultivate	耕作；陶冶
curb	遏制
curl	鬈发
current	当前的
curse	咒骂；骂人话
curve	曲线
cute	可爱的
dairy	奶制品
damn	〈口语〉倒霉!
darling	亲爱的
date	日期；约会
dean	（大学的）院长
decay	腐烂
deceit	欺骗
deceive	欺骗
decent	体面的
deception	欺骗
decisive	果断的
deck	甲板
deem	认为
defect	缺陷
defected	叛逃的
defendant	被告
defiance	违抗
defiant	违抗的
deficiency	缺乏
deficit	赤字
defy	违抗
delegate	会议代表
deliberated	深思熟虑的
democracy	民主
democrat	民主党党员
dense	稠密的
dent	凹陷
dental	牙科的
depart	离开
deputy	副的
descend	下降
descent	血统
desktop	桌面
despair	绝望
detail	细节
deteriorate	恶化
devil	魔鬼
devise	制定
dew	露水
diabetes	糖尿病
diagnose	诊断
diagnosis	诊断
dialect	方言
diameter	直径
digit	数字，数位
dignify	使有尊严
diligent	勤奋的
dim	昏暗的
dime	一毛钱
dine	就餐
diplomacy	外交
diplomat	外交官
disapprove	不赞成
discard	丢弃
discharge	排放
discipline	纪律
disco	迪斯科舞厅
disguise	伪装
disintegrate	瓦解
disorder	无秩序，混乱
dispute	争端
disrupt	扰乱
disruptive	破坏性的
dissolve	溶解
distract	使分散注意力
distress	痛苦；困境
ditch	沟
diversify	使多元化
divisive	导致分裂的
dock	码头
doctorate	博士学位
documentary	纪录片
dolphin	海豚
donkey	驴
donor	捐助者
doom	厄运
dose	剂量
dragon	龙
drain	下水道；排水
drainage	排水
drastic	猛烈的
drift	漂移
drip	滴
dropout	退出者；退学者
drought	干旱
drown	使淹死
drunkard	酒鬼
drunken	醉酒的
dual	双的
dumb	哑的
dump	丢弃
durable	耐用的
dye	染料
earnest	郑重其事的
ease	容易
easy-going	随和的
echo	回声
ecological	生态（学）的
efficient	高效的
elbow	肘
elective	选修课
electron	电子
elegance	优雅
elementary	基础的；小学的
elevate	使升高
elite	精英
embrace	拥抱
emit	发出
emotion	情感
emphatic	强调的
empire	帝国
empress	女皇；皇后
endurance	耐力
endure	忍耐
engage	参与
enlighten	启迪
enrich	丰富
enrol	报名
entitle	给（书等）取名；使有权
entrepreneur	企业家
entrepreneurial	企业家的
episode	（电视剧的）一集
era	时代
err	犯错
erroneous	错误的
essence	本质
essential	根本性的
eternal	永恒的
eternity	永恒
euro	欧元
eve	前夕
evil	邪恶；邪恶的；恶行
exaggerate	夸大
excel	擅长
excess	过剩的
exclaim	惊叹
excursion	游览
execute	执行
executive	行政的；常务的
exemplar	范例
exemplify	举例说明
exert	发挥
exhaust	使筋疲力尽；废气
exhaustion	筋疲力尽
exhaustive	详尽的
exile	流放
expanse	广阔
expansion	扩展
expel	驱逐
expend	花费
explosion	爆炸
expressway	高速公路
exterior	外观
extinguish	熄灭
eyebrow	眉
fable	寓言
fabric	织物
facility	设施
faculty	全体教师；特殊才能
faint	微弱的；晕倒
fairy	仙子
fake	假的
famine	饥荒
farewell	告别
fascinate	使着迷
fashion	时尚；时装
fatal	致命的
fate	命运
fatigue	疲劳
feasible	可行的
federate	联盟
feedback	反馈
fertile	肥沃的
figurative	比喻的
filter	过滤器
fingerprint	指纹
fireman	消防员
fireplace	壁炉
firstly	首先
fixate	使固定
fixture	固定装置
flavour	味道
flaw	缺陷
fleet	舰队
flock	一群
flourish	兴旺
fluid	流体
footprint	足迹
fore	前部
foresight	远见
forestry	林业
forge	锻造
formal	正式的
forth	向前
forum	论坛
fossil	化石
fraction	分数
fragment	片段
frame	框架
frank	直率的
freight	货运
freshman	大一新生
fruitful	富有成果的
frustrate	挫败
fuck	〈禁忌〉性交
fulfil	完成
furnace	炉子
fuss	大惊小怪
gadget	小装置
gamble	赌博
gang	团伙
gangster	歹徒
gaol	监狱
gap	差距
gaze	注视
gear	齿轮
gene	基因
generator	发电机
genetic	遗传的
genius	天才
genuine	真的
geological	地质（学）的
geology	地质学
germ	细菌
ghost	鬼
giant	巨人
gigantic	巨大的
glimpse	一瞥
gloom	忧郁
glow	发光
gorgeous	华丽的；棒的
gossip	说长道短
gown	女礼服
grab	抓
grace	优美
gracious	优美的
grammatical	语法的
graphic	书写的；生动的
gratitude	感激
grave	坟墓
greenhouse	温室
grief	悲伤
grieve	使悲伤
grievous	令人伤心的
grin	咧嘴笑
grind	磨碎；磨
grip	紧握；吸引
gross	总的，毛的
guardian	保卫者
gulf	海湾
gum	牙龈；口香糖
gut	肠子；内脏
guy	〈口语〉男人；家伙
habitat	栖息地
hack	砍
hail	冰雹；招呼
halt	停止
handbook	手册
handicap	使残疾
hardware	硬件
harness	马具；利用（能源）
harsh	苛刻的
haste	仓促
haul	拖；拽
haunt	出没
hay	干草
hazard	危害
haze	薄雾
hazy	模糊的
headmistress	女校长
headquarters	总部
heal	治愈
heap	一堆
hearty	衷心的；丰盛的
hectare	公顷
hedge	树篱
heighten	加强
heir	继承人
hell	地狱
herd	牛群；〈贬义〉人群
hereby	特此
heritage	遗产
heroine	女主角
hesitant	犹豫的
high-tech	高科技的
hijack	劫持
hinder	阻碍
hint	提示
hip	臀部
hollow	空心的
honeymoon	蜜月
horizon	地平线
horizontal	水平的
horn	喇叭
horrifying	令人恐怖的
horror	恐怖
horsepower	马力
hospitable	好客的
hospitality	好客
hostile	敌对的
household	住户
humble	谦卑的
hut	小屋，舍
hyphen	连字符
ideal	理想；理想的
idealistic	理想主义的
idle	空闲的
illusion	幻觉
illusory	虚幻的
imitate	模仿
immense	巨大的
immigrant	移民
immune	免疫的
impatience	不耐烦
impatient	不耐烦的
imperial	皇帝的
impulse	冲动
incidental	附带的
incredible	难以置信的
indifference	冷漠
indifferent	冷漠的
indispensable	不可或缺的
industrious	勤劳的
infant	幼儿
infect	感染
inferior	低于别人的
infinite	无限的
infinity	无限
inflate	使膨胀
ingredient	成分；配料
inhabit	居住
inhabitant	居民
inherit	继承
inland	内陆的
inquire	问询
install	安装
instalment	批次
instinct	本能
insult	侮辱
intact	不变的
intake	摄入量
intellectual	知识的；知识分子
interfere	干扰
interior	内部的
intimate	亲密的；关系暧昧的
intrude	侵扰
intrusion	侵扰
invade	入侵
invasion	入侵
invasive	扩散性的
inward	向内
irony	讽刺
jail	监狱
jealous	嫉妒的
jetlag	时差
joint	联合的
junk	垃圾
juror	陪审员
jury	陪审团
keen	热衷的
kin	亲朋
kit	工具包
kneel	跪
knit	针织
knot	结
lace	花边
ladder	梯子
lag	滞后
landlady	女房东；女地主
landlord	房东；地主
landscape	景观
lane	车道
laptop	笔记本电脑
laser	激光
launch	发射
lavatory	厕所
lawn	草坪
layoff	裁员
layout	布局
lean	倚，靠
leap	跳跃
lease	租赁
leisure	休闲
lens	镜头
lest	以免
liable	承担责任的
lick	舔
lily	百合
limb	肢
linear	线性的
liquor	白酒
literacy	识字，读写能力
literal	字面的
livelihood	生计
liver	肝
living-room	客厅
loan	贷款
lobby	大堂
locality	位置，地点
locker	更衣柜
lodge	小屋，小舍
log	日志
logo	徽标
loophole	漏洞
lord	君主；上帝
loyal	忠诚的
lump	块
lunar	农历的
luxury	奢侈
magnet	磁铁
magnificent	壮丽的
mainstream	主流
makeup	化妆
mall	购物中心
mammal	哺乳动物
manufacture	制造
marine	海洋的
marital	婚姻的
marsh	沼泽
marshal	元帅
marvel	奇迹
Marx	马克思
massage	按摩
massive	大量的
masterpiece	杰作
mate	交配
maximal	最大的
mayor	市长
meantime	同时
mechanic	机械工
mechanise	使机械化
melt	融化
memo	备忘录
memorandum	备忘录
mend	修理
merit	优点
meritorious	值得称赞的
messenger	使者
metro	地铁
microphone	麦克风
middle-class	中产阶级的
mighty	强大的
migrant	移居者，流动者
mill	磨坊
miner	矿工
miracle	奇迹
miraculous	奇迹般的
miserable	悲惨的
misfortune	不幸
mission	使命
moderate	适度的
moist	潮湿
monetary	货币的
monster	怪物
mood	心情
moreover	此外
mortgage	按揭
motel	汽车旅馆
motion	议案
motorway	〈英〉高速公路
mould	模子
mount	装配
mug	缸子
mule	骡
multiple	多重的
municipal	市的，市政的
muscle	肌肉
muscular	肌肉的
mystery	神秘
myth	神话
mythic	神话的
mythology	〈总称〉神话
naked	裸体的
nap	午休
napkin	餐巾
narrate	讲述
nasty	令人讨厌的
naughty	淘气的
naval	海军的
necessitate	使必要
necessity	必要性
needy	贫困的
negative	负面的
neglect	忽视
negotiable	可谈判的；面议的
nerve	神经
nicety	准确；细节
nickel	镍
nightmare	噩梦
nonsense	胡说八道
nosy	爱管闲事的
notate	标注
notification	告知
notify	告知
notional	概念的
noun	名词
nourish	滋养
novelty	新奇
nucleus	核；核心
nude	裸体的
nuisance	滋扰
numerous	许多的
nutrient	营养物
nutrition	营养
obese	肥胖的
oblige	迫使
obstacle	障碍
occasion	场合
odour	气味
offend	冒犯
old-fashioned	老式的
Olympiad	奥林匹克运动会，奥运会
omit	省略
online	在线
onwards	朝前
opponent	对手
opportunity	机遇
opt	选择（后跟for）
optimism	乐观
orchestra	管弦乐队
ore	矿石
organic	有机的
organism	有机体
ornament	饰品
orphan	孤儿
orphanage	孤儿院
ounce	盎司
outdated	过时的
outlet	插座
outlook	前景
outset	开始
outskirts	郊区
oven	烤箱
overdue	逾期的
overhear	无意间听到
overnight	一夜之间
oversee	监督
oversight	疏忽
overtake	超，超越
overthrow	推翻
overtime	超时，加班
overwhelm	淹没；使崩溃
ozone	臭氧
pad	垫
paddy	稻子；稻田
palm	棕榈；手心
pants	〈主美〉裤子
paperback	平装书
parade	游行
paradox	悖论
parliament	议会
particle	粒子
passion	激情
password	密码
paste	粘贴
pastime	消遣
pat	轻拍
patch	补丁
paw	爪子
payroll	工资单
peak	峰
peanut	花生
pearl	珍珠
peasant	农民
peasantry	〈总称〉农民
peculiar	奇特的
peer	同龄人
penalise	惩罚
penalty	惩罚
penetrate	穿透
perceptive	感知的
peril	危险
permissive	允许的
persevere	坚持不懈
personality	个性
pessimism	悲观
pessimist	悲观主义者
pessimistic	悲观的
petroleum	石油
petty	小的；心眼小的
picturesque	如画的
pierce	刺入
pigeon	鸽子
pillar	支柱
pinch	捏
piracy	海盗；盗版行为
pirate	海盗
pistol	手枪
pit	坑
pitch	沥青
pizza	比萨饼
plague	瘟疫
plantation	种植园
pledge	保证；信物
plough	犁
plunge	跳入；使陷入
plural	复数
polar	极地的
poll	投票；民意测验
pollster	民意测验专家
populous	人口多的
posture	姿势
poverty	贫困
preach	布道，传
precaution	预防措施
preface	序
presidency	总统职位
prevail	盛行
prevalent	盛行的
priest	牧师
prince	王子
princess	公主
privatise	使私有化
procession	队伍
proclaim	宣告
proficient	熟练的
profound	深刻的
projector	投影仪
prominence	突出
prominent	突出的
prompt	提示
proof	证据
property	财产
propose	建议
proposition	命题
prose	散文
protein	蛋白
protest	抗议
proverb	谚语
provision	提供；[-s]食品
provoke	引发
publicize	宣传
punch	用拳头猛击
purify	使净化
pursuit	追求
quantify	量化
quota	定额
rack	行李架
radar	雷达
rage	愤怒
ragged	衣衫褴褛的
raid	突袭
rally	集会
realm	界，领域
reap	收获
rear	后方
rebel	反叛
recall	召回
receptive	接受的
recession	经济衰退
recipient	收件人
reckon	估计
recruit	招聘
refrain	避免（后跟from）
registrar	学籍管理员
relativity	相对；相对论
relieve	减缓
remedy	补救办法
render	使处于；翻译
renovate	翻修
repay	偿还
repetitive	重复的
reproduce	复制；再现
reproductive	生殖的
resent	怨恨
resolution	决议
resort	度假村
respective	各自的
response	响应
resume	恢复；简历
retail	零售
retention	保留
retreat	撤退
reunion	团聚
revolve	旋转
rhythm	节奏
rib	肋骨
ribbon	带子；装饰带
ridicule	嘲弄
rifle	步枪
riot	骚乱
rip	撕裂
rival	竞争对手
roar	轰鸣
rod	棍棒；杆
romantic	浪漫的
rose	玫瑰
rouse	唤醒
rub	擦
rug	地毯
rumour	谣言
runway	跑道
rural	农村的
sack	麻袋
saint	圣；圣徒
sake	名义
sample	样本
sane	神志正常的
sauce	汁
scale	规模
scandal	丑闻
scarce	稀有的
scatter	分散
scent	气味；香味
scout	童子军；侦察舰
screw	螺丝
script	脚本，讲稿
scripture	经文；圣经
segment	片段
seizure	发作
semester	学期
semi	半
semi-colon	分号
senate	参议院
senator	参议员
sensible	明智的
sensor	传感器
setback	挫折
shed	棚
sheer	纯粹的
shell	壳
shit	粪便，屎
shiver	颤抖
showy	艳丽的
shrimp	虾
shrug	耸肩
siege	围攻
sign	标记
silicon	硅
sin	罪
singular	奇异的
skeleton	骨架
sketch	素描
sketchy	不完全的
skinny	瘦的
skyline	天际线
slap	掌击
slender	细长的
slipper	拖鞋
slippery	滑的
slogan	口号
slope	坡
smash	粉碎
snack	小吃
soak	浸泡
soar	升空；飞涨
sociable	善于交际的
socialise	社交
sociology	社会学
soda	苏打水
solemn	庄严的
soluble	可溶的
solution	解决办法
solve	解决
solvent	不负债的；溶剂
sophisticated	复杂的
sophistication	复杂
sore	疼痛的
spacecraft	航天器
span	跨度
spark	火花
sparkle	闪烁
spatial	空间的
species	物种
specimen	标本
speculate	推测
spill	漏；泄露
spite	恶意（用作in spite of，尽管）
splash	溅
splendour	辉煌
spoil	溺爱
spontaneous	自发的
sportsman	运动员
spouse	配偶
spur	激励
stack	堆
staircase	楼梯
stake	赌注，风险
stale	陈的；陈旧的
standpoint	立场；角度
startle	使惊吓
stationary	静止的
steamer	汽船；蒸笼
steer	引导
stem	干；题干
stiff	僵硬的
stimulant	刺激物；兴奋剂
stimulate	刺激
stimulus	刺激
sting	毒刺
stir	搅拌
stock	股票
stool	凳子
storey	楼层
stormy	猛烈的
strain	拉紧
strap	表带
stretch	伸展
stride	大步行走
strip	脱掉；剥
stripe	条纹
strive	力争
stroke	中风
stuff	东西
stuffy	不通气的，闷的
submissive	顺从的
substance	物质
subtract	减
suburb	郊区
subway	地铁
summit	首脑会议
sunrise	日出
sunset	日落
superficial	肤浅的
supervise	监督
supposition	猜测
supremacy	至高无上
surf	冲浪
surge	涌；猛升
surgery	手术
surgical	外科的
surname	姓氏
surrender	投降
suspense	悬念
suspicion	怀疑
suspicious	可疑的
sway	摇摆
swipe	刷（卡）
sympathise	同情
tackle	处理
tag	标签
tame	驯服
tangible	有形的
technician	技术员
tedious	单调乏味的
teen	青少年
telecommunication	电信
teller	出纳
temper	脾气
tender	脆弱的；心肠软的
terrific	棒的
territory	领土
textile	纺织
Thanksgiving	感恩节
therapy	治疗
thermometer	温度计
threat	威胁
thrive	繁荣
thrust	推
thumb	拇指
tide	潮
timber	木材
toe	脚趾
token	标志；代币
toll	过路费
tone	语气
torch	火炬
torture	折磨
toss	抛，掷
touchy	敏感的
township	镇
trademark	商标
traffic	贩卖
tragedy	悲剧
tragic	悲剧的
trail	足迹
trailer	拖车；预告片
transact	办理
transcript	成绩单；转写
transition	过渡
transparency	透明
transplant	移植
trash	垃圾
tray	托盘
treaty	条约
tremendous	巨大的
trifle	小事
triple	三倍的
triumph	胜利
triumphant	胜利的
trolley	购物车
trustee	受信托人
tuition	学费
tumour	肿瘤
tunnel	隧道
tutorial	教程
underestimate	低估
undergraduate	本科的；本科生
undermine	破坏
undo	撤消
upgrade	升级
upload	上传
upright	正直的
up-to-date	最新的
usage	使用
utility	有用；水电
utmost	最大的
utter	说出
vacancy	空缺
vacuum	真空
van	面包车
vanish	消失
vanity	虚荣
vapour	水汽
vegetarian	素食者
veil	面纱
vendor	小贩
venture	企业
verb	动词
verbal	口头的
verify	核实
versus	对
vessel	容器
veteran	退伍军人
veto	否决权
viewpoint	观点
vigorous	精力充沛的
vigour	精力
vitamin	维生素
vocation	职业
volt	伏特
voluminous	大量的
vulnerable	易受伤害的
wagon	马车
ware	制品
warfare	战争
warrior	战士
wary	谨慎的
watchful	警惕的
waterproof	防水的
watertight	防水的
wavy	波浪的
weapon	武器
weaponry	〈总称〉武器
weave	编织
weird	怪异的
well-being	福祉
well-known	知名的
well-off	小康的
whatsoever	无论什么
whip	鞭子；鞭打
whiskey	威士忌酒
wide	宽的
wilderness	荒野
willpower	意志
wireless	无线的
wit	机智
withstand	承受
workforce	劳动人口
workout	锻炼
workshop	研修班
worship	崇拜
wrap	包，裹
wreck	残骸
Yankee	〈美〉北方人
yield	产，出；屈服
yoga	瑜伽
zoology	动物学